 ### # ##### ######### ######### #######
#...#.#.....#.........#.........#.......#
#.#.#.#.#.###.#######.#.###.###.###.###.#
#.#...#.#.....#.#...#...#...#.#.#...#.#.#
#.###.#.#######.#.#.#####.###.#.#.###.#.#
#...#.#.#.......#.#.......#...#.#...#...#
#.#.#.#.#.#####.#.#.#######.#.#.#.#.###.#
#.#.#.#.#.#...#.#.#.#...#...#.#.#.#...#.#
 ##.#.#.#.#.#.###.###.#.###.#.#.#####.##
#...#.#.#...#...#...#.#...#.#.#.#...#...#
#.## ##.#.## ##.###.#.###.#.###.#.#.###.#
#...#...#...#.....#...#.#.#...#...#...#.#
#.#.#.#####.#.###.#####.#.#.#.#######.#.#
#.#...#...#.#.#...#.....#.#.#.......#.#.#
#.#####.#.###.#.#######.#.#.#######.#.#.#
#...#...#.....#.#.....#.#.#.#.#.....#...#
 ##.#.#########.#.###.#.#.#.#.#.#######.#
#...#.#.....#.....#.....#.#...#.........#
#.###.#.#####.#########.#.###.##########
#.#...#.........#.....#.#.#.........#...#
#.###.#.#########.###.###.#########.#.##
#.#...#.....#.....#.#.#...#...#.#...#...#
#.#.## ####.#.#####.###.###.#.#.#.#####.#
#.#...#...#.#.#...#...#.....#.#...#.....#
#.###.#.###.#.#.#.###.#.#####.###.#.#.##
#.....#.....#.#.#...#.#.....#...#.#.#...#
 ######.#####.#.###.#.#####.###.#.## ##.#
#...#...#...#.#.#.#.#...#...#.#.#...#...#
#.###.#####.#.#.#.#.#.#.#.###.#.###.#.##
#.#...#.....#...#...#.#.#.....#.#.#.#...#
#.#.###.###.#####.###.###.#####.#.#.###.#
#.#.#...#...#...#.#.#.....#...#.#.....#.#
#.#.#.###.#####.#.#.#.#####.#.#.#####.#.#
#...#.#.#.#.....#.#...#.....#.#.....#...#
#.###.#.#.#.###.#.###.#.#####.#.###.###.#
#.#...#.#...#...#...#.#.#.....#.#...#.#.#
#.###.#.###.#######.###.#.#### ##.###.#.#
#.#...#...#.#.......#...#.#...#...#.....#
#.#.###.#.#.#.#######.###.#.#.#.###.####
#...#...#...#.........#.....#...#.......X
 ### ### ### ######### ##### ### #######